####--
#-.#--
#--###
#*@--#
#--$-#
#--###
####--

Keys for solution are:sawdddsawaassdwawdwwasdssddwasaww

Time taken to run: 2.0589494705200195 seconds
