####--
#--###
#-$$-#
#...-#
#-@$-#
#---##
#####-

Keys for solution are:wawwdsassdsdwdwwaawas

Time taken to run: 0.40094900131225586 seconds
