#####-
#-@-#-
#...#-
#$$$##
#----#
#----#
######

Keys for solution are:asswddswaasdssawwdssddwawssaww

Time taken to run: 3.193769693374634 seconds
