####----
#--###--
#----###
#--$*@-#
###-.#-#
--#----#
--######

Keys for solution are:dssaawawdwadsssddwwadssaawawaawwdsasdwddswaasd

Time taken to run: 0.22686004638671875 seconds

28 terminal nodes and 15 non terminals
