######
#...-#
#--$-#
#-#$##
#--$-#
#--@-#
######

Keys for solution are:awawwdwddsawaasssdsddwawwadsssaawwwssdsdwaawwdddwasaassddww

Time taken to run: 0.39983487129211426 seconds

33 terminal nodes and 22 non terminals
