-######
##----#
#--##-#
#-#-$-#
#--*-.#
##-#@##
-#---#-
-#####-

Keys for solution are:saawwdwdsdwsaaassddwsaawwdwddsassaawwawwdwdddss

Time taken to run: 0.4082827568054199 seconds
