-#####-
-#---#-
##---##
#-$$$-#
#-.+.-#
#######

Keys for solution are:wsaawdwwddssadwwaasswwdss

Time taken to run: 0.34122228622436523 seconds
