-####--
##--###
#-----#
#.**$@#
#---###
##--#--
-####--

Keys for solution are:waaswaassdwdwddsaaassdwawdwwasdddsa

Time taken to run: 1.6974260807037354 seconds

52 terminal nodes and 96 non terminals
