######
#----#
#-#@-#
#-$*-#
#-.*-#
#----#
######

Keys for solution are:dssadwwaswwaassd

Time taken to run: 0.017353296279907227 seconds

8 terminal nodes and 3 non terminals
