#######-
#-----#-
#@$$$-##
#--#...#
##----##
-######-

Keys for solution are:wdddswaasdwddsssaaawawwddsdwdsaawaasdddaassddwdasaawwdwddswas

Time taken to run: 0.555304765701294 seconds

56 terminal nodes and 33 non terminals
