####---
#--####
#-.-.-#
#-$$#@#
##----#
-######

Keys for solution are:saaawsdwaawwdsdssaw

Time taken to run: 0.1296522617340088 seconds
