####---
#--####
#.*$--#
#-.$#-#
##-@--#
-#---##
-#####-

Keys for solution are:awawwdsdswaasdssddwdwwaaddssaasawdddwwaaadddssaawsddwwaa

Time taken to run: 5.083388805389404 seconds
