######
#----#
#-.--#
#--$-#
#@---#
######

Keys for solution are:ddwdwa

Time taken to run: 0.0007147789001464844 seconds
