######
#.$--#
#-@--#
######

Keys for solution are:dwa

Time taken to run: 0.0015401840209960938 seconds
