######
#.$--#
#----#
#----#
#@---#
######

Keys for solution are:wwddwa

Time taken to run: 0.003189563751220703 seconds
