######
##.###
#-*--#
#--$-#
#@---#
######

Keys for solution are:wdwddsasaw

Time taken to run: 0.08396434783935547 seconds
