##########
##.#######
#-*------#
#--$-----#
#-------@#
##########

Keys for solution are:aaaawasaawdwddsasaw

Time taken to run: 200.82632160186768 seconds
