#######
#-----#
#.-.--#
#-##-##
#--$-#-
###$-#-
--#@-#-
--#--#-
--####-

Keys for solution are:dwwwwaaassddsdssawdwwwsaaawwddwddsassssawdwwwwaasassddsdwaaawwdwddsawaasssdddwsaaawwwddsadwddsa

Time taken to run: 15.996573209762573 seconds
