-####--
-#--###
-#-$$-#
##...-#
#--@$-#
#---###
#####--

Keys for solution are:wddsawaawwdsasdassdwddwwaawas

Time taken to run: 1.3353230953216553 seconds
