#####--
#---###
#.-.--#
#---#-#
##-#--#
-#@$$-#
-#----#
-#--###
-####--

Keys for solution are:sdddwwasdsaasawwwwawddsasssddwasawwwdwasssddwdwwa

Time taken to run: 5.572246074676514 seconds

153 terminal nodes and 211 non terminals
