#######
#.-#--#
#--$--#
#.-$#@#
#--$--#
#.-#--#
#######

Keys for solution are:waaasawddddssaaddwwaaasassdwawwddswddssaaadwwaassddwa

Time taken to run: 44.05582809448242 seconds
