#####----
#---##---
#-$--#---
##-$-####
-###@.--#
--#--.#-#
--#-----#
--#######

Keys for solution are:wwawaasdsdawwdsdssdssaawdwwwaasdwdssdddssaawsaawd

Time taken to run: 0.24320292472839355 seconds
