#####-----
#---####--
#-#-#-.#--
#----$-###
###-#$.--#
#---#@---#
#-#-######
#---#-----
#####-----

Keys for solution are:dwwaaawwaassdawwddssdddssawdwaaawwaassddddwdsaaassaassddwwwwaawwddswaassddddsdwssddwa

Time taken to run: 4.07868766784668 seconds

40 terminal nodes and 118 non terminals
