########
#---..-#
#--@$$-#
#####-##
---#--#-
---#--#-
---#--#-
---####-

Keys for solution are:wddsssassdwwwwdwaaasaawdsddwdsaaawdsddssassdwwww

Time taken to run: 5.062704801559448 seconds
