#######--
#-----###
#--@$$..#
####-##-#
--#-----#
--#--####
--#--#---
--####---

Keys for solution are:wdsdassassdwwdddwwaaaaddddssaaawsdddwwaawaasddaawaasddwddsdawaasdd

Time taken to run: 12.712584733963013 seconds

592 terminal nodes and 739 non terminals
