--####----
###--#####
#--$--@..#
#-$----#-#
###-####-#
--#------#
--########

Keys for solution are:aawasswaasddwdddddsssaaaaawwawddasssdddddwwwaasaaddwddsssaaaaawwdwddaasaawddsddwdasaawdd

Time taken to run: 3.2333931922912598 seconds
