#######
#-----#
#-#-#-#
#.-$*@#
#---###
#####--

Keys for solution are:wwaaaassdsdwaawwddddssaaadddwwaaswddssaasaawddwwaas

Time taken to run: 0.1338639259338379 seconds

10 terminal nodes and 20 non terminals
