--######-
--#----#-
--#-##@##
###-#-$-#
#-..#-$-#
#-------#
#--######
####-----

Keys for solution are:waaassssddddwasaaawwwwdddsssdsaaaawaassdwawdsddddwwasdsaaawaassdwdddwwdwwaaass

Time taken to run: 63.67249870300293 seconds
