-#####
-#-@-#
-#---#
###$-#
#-...#
#-$$-#
###--#
--####

Keys for solution are:sdssawsdssawwaasdwddssawdwadwwwaasdwdsswas

Time taken to run: 6.282057523727417 seconds
