--####-
-##--#-
##@$.##
#-$$--#
#-.-.-#
###---#
--#####

Keys for solution are:daswdwdssdssaawwawd

Time taken to run: 0.7045438289642334 seconds
