--#######--
###-----#--
#-$-$---#--
#-###-#####
#-@-.-.---#
#---###---#
#####-#####

Keys for solution are:dddwwwaasddssaaaawwdddwdsswaaaassddddwwwddsawasaaaassddddddsddwaaaaaasaawwwddddswaaaasssddwddaasaawdd

Time taken to run: 6.899338245391846 seconds

208 terminal nodes and 215 non terminals
