-----###-
######@##
#----.*-#
#---#---#
#####$#-#
----#---#
----#####

Keys for solution are:sdsssaawwssddwwwaaaasaawddddsssddwwadssaaww

Time taken to run: 0.4424901008605957 seconds

38 terminal nodes and 58 non terminals
