########
#------#
#-.**$@#
#------#
#####--#
----####

Keys for solution are:waasadwddsaawaaassdddwddssawdwa

Time taken to run: 4.381191730499268 seconds

921 terminal nodes and 274 non terminals
