--####--
--#--#--
--#@-#--
--#--#--
###-####
#----*-#
#--$---#
#####.-#
----####

Keys for solution are:sssdsadddwaasawaasdddwawwdwwassssasdwdddssawdwaaasaawdsddwdsaaawdd

Time taken to run: 3.4650793075561523 seconds

117 terminal nodes and 278 non terminals
