########--
#-@-#--#--
#------#--
#####$-#--
----#--###
-##-#$-..#
-##-#--###
----####--

Keys for solution are:sddddssawsdssawwdwwaaawaasddddwdsssasdwawdwaaawaasddddwdssassddaawwdsasd

Time taken to run: 7.533543348312378 seconds

176 terminal nodes and 439 non terminals
