#####--
#---##-
#-#--#-
#@$*.##
##--.-#
-#-$#-#
-##---#
--#####

Keys for solution are:wwddsswwaassdawwddsdssadwwawaassddsddssaawawdwwwaassd

Time taken to run: 0.4510469436645508 seconds

30 terminal nodes and 54 non terminals
