####---
#.-##--
#.@-#--
#.-$#--
##$-###
-#-$--#
-#----#
-#--###
-####--

Keys for solution are:sssdssawwdsddwasaawwssddwawawawwdsdssawdwasssdssawwdsddwasawawwawsddwasdsassddwasawwdwa

Time taken to run: 11.418509244918823 seconds

208 terminal nodes and 748 non terminals
