######-
#---.#-
#-##-##
#--$$@#
#-#---#
#.--###
#####--

Keys for solution are:sawassaawwwwdddswaaassssddwwadsddwawwaaassswddsdww

Time taken to run: 0.41228437423706055 seconds

24 terminal nodes and 52 non terminals
