#####---
#---###-
#-.---##
##*#$--#
#-.#-$-#
#-@##-##
#-----#-
#######-

Keys for solution are:sdddwwawsddwawaawaasdssassdwsdddwwwwaawasdddssawdwaa

Time taken to run: 0.5774633884429932 seconds

23 terminal nodes and 38 non terminals
