-####-----
-#--######
##----$--#
#-.#-$---#
#-.#$#####
#-.@-#----
######----

Keys for solution are:awwwddddsddwaaaaawassassdddwwssaaawwdwddddsadddwasaawaaasassdddwwdwaddaasssaaawwdswwddsddwadsddwasaawadsddwasaawawasswddsddwaaawas

Time taken to run: 185.37668442726135 seconds

4746 terminal nodes and 6114 non terminals
