-#####
-#---#
-#-.-#
##-*-#
#--*##
#--@##
##-$-#
-#---#
-#####

Keys for solution are:awwwddsasasssddwawssawwdwwssaawdwddwwaassssdssawwdwsaawd

Time taken to run: 3.811760663986206 seconds

160 terminal nodes and 165 non terminals
