-#####-
##.-.##
#-*-*-#
#--#--#
#-$-$-#
##-@-##
-#####-

Keys for solution are:awawwdwddsaddssawwsssaawdsdwaaawwddaassdwwssdddwwaaddssaw

Time taken to run: 0.7575953006744385 seconds

35 terminal nodes and 91 non terminals
