-#########
-#----#--#
##-$#$#--#
#--.$.@--#
#--.#----#
##########

Keys for solution are:aaasaawdddaawwdssdddaaawwddswaassddsddwaddwwasdssaawaaddsddwaa

Time taken to run: 4.677691698074341 seconds

119 terminal nodes and 228 non terminals
