###########
#----.##--#
#-$$@..$$-#
#---##.---#
###########

Keys for solution are:waaassddwsaawwddsdddsdddwwasaddsaawaawaassaawwdddasdawaasdwddsdawaasdd

Time taken to run: 163.54626202583313 seconds

1741 terminal nodes and 5886 non terminals
