---####
---#--#
---#@-#
####$.#
#---$.#
#-#-$.#
#----##
######-

Keys for solution are:dsssasaaawwdddwdwwasssaaassdddwdwwssasaaawwdddwdswawwdsassssawsaawwddd

Time taken to run: 6.714404106140137 seconds

324 terminal nodes and 444 non terminals
