######--
#--@-#--
#--#-##-
#-.#--##
#-.$$$-#
#-.#---#
####---#
---#####

Keys for solution are:dsssadwdsdssaawsddwwaaddsawawwwaassassdwwawwdddsssadwwwaaassdswawwdsassddddssawdwaa

Time taken to run: 46.008774757385254 seconds

779 terminal nodes and 1608 non terminals
