######-#####
#----###---#
#-$$-----#@#
#-$-#...---#
#---########
#####-------

Keys for solution are:saaaaawawaaassdawwdsddaaassdwawdwddsdddaaawaasdddsdddddwwaaswddssaawaaddsawaaawaasdddddsdddwwaasasadwdwddssaaawaaaaassdwawdddddsdddwwaaswddssaa

Time taken to run: 30.038531064987183 seconds

659 terminal nodes and 590 non terminals
