--####
###-@#
#--$-#
#--*.#
#--*.#
#--$-#
###--#
--####

Keys for solution are:ssadwwasaasssddsdwaawawwdsdaassdwawd

Time taken to run: 0.2563037872314453 seconds

69 terminal nodes and 20 non terminals
