#####--
#---###
#--$--#
##*-.-#
-#---@#
-######

Keys for solution are:wwaawaasdwdsdssaawdwwas

Time taken to run: 0.0868375301361084 seconds

17 terminal nodes and 13 non terminals
