--####---
###--####
#-------#
#@$***.-#
#-------#
#########

Keys for solution are:sdddwdasaaawwddwdsdssaawdasaawddsddddwwaaawas

Time taken to run: 114.89409232139587 seconds

10116 terminal nodes and 2747 non terminals
