--######
--#-..@#
--#-$$-#
--##-###
---#-#--
---#-#--
####-#--
#----##-
#-#---#-
#---#-#-
###---#-
--#####-

Keys for solution are:aassssssasssddwwadssaawwdwadwwwwwwddsawassssssassaawwddsssddwwawwwwwwssssssdssaawwdwwwwwwawdsssssssasaawwddsdwwwwww

Time taken to run: 74.47479295730591 seconds

411 terminal nodes and 3299 non terminals
