##########
#--------#
#-##.###-#
#-#-$$-.-#
#-.-@$##-#
#####----#
----######

Keys for solution are:aaawwwdddsswwddddssaaadddssaaawaadwdd

Time taken to run: 15.791847229003906 seconds

87 terminal nodes and 679 non terminals
