#####---####-------
#---#####-.#-------
#-------$--########
###--####-.$----@-#
--#--#--#--####---#
--####--####--#####

Keys for solution are:aaaaaawaaaaaaawaasdwdsdddddddssawdwaaaaaaawaasddddddddwdsaaaaaassawdwawaasddddddddsdwsdddddsddwaaaaaa

Time taken to run: 51.44074535369873 seconds

31 terminal nodes and 1170 non terminals
