####----
#--#####
#-$$-$-#
#------#
##-##-##
#...#@#-
#-###-##
#------#
#--#---#
########

Keys for solution are:wwaaaawwdssswddwasaawwdssddddwaaasaawwdsdsddssssaaaawwdassddddwwwwaawaasddwddsssssaaaawwdwsassddddwwwwwaasdwdsswaawaasdwddsdssswwwawaasssassdddsddwaadwwwwaawasswdddssssaaasaww

Time taken to run: 14.15468692779541 seconds

290 terminal nodes and 443 non terminals
