#####-
#.--##
#@$$-#
##---#
-##--#
--##.#
---###

Keys for solution are:wddswaasdsdawwdsdssawdwasawdwa

Time taken to run: 49.62088584899902 seconds
