#####--
#---#--
#-@-#--
#-$$###
##.-.-#
-#----#
-######

Keys for solution are:dswaasdssddwasawwawwddssasdwwwass

Time taken to run: 1.6049940586090088 seconds
