#######
#--*--#
#-----#
##-#-##
-#$@.#-
-#---#-
-#####-

Keys for solution are:sawddwwaawdsdssaawsddwwawaasdssddwwdwaadsssaawwdwdsaaawdsdds

Time taken to run: 1.6985530853271484 seconds
