#-#####
--#---#
###$$@#
#---###
#-----#
#-.-.-#
#######

Keys for solution are:waassassddwawasdwwwddsawassasdsddwaawaassddwwas

Time taken to run: 0.2098863124847412 seconds

26 terminal nodes and 21 non terminals
